11111000000000000000
00000000111110000000
00000000000000001110
00000000000000000000
00000001110000000000
00000000001111100000
00000000000000000000
00000000011000000000
00000110011100000000
00000000000000110000
00000001000000000000
00000001000000000000
00000000001000000000
00000000001000000000
00000000000000000000